//MAP CONVERTED BY dmm2tgm.py THIS HEADER COMMENT PREVENTS RECONVERSION, DO NOT REMOVE
"a" = (
/obj/machinery/conveyor/auto{
	use_power = 0
	},
/obj/structure/disposalpipe/segment,
/turf/open/floor/plating,
/area/centcom/tdome/arena)
"b" = (
/obj/effect/turf_decal/tile/brown/half,
/turf/open/floor/iron/smooth_edge,
/area/centcom/tdome/arena)
"c" = (
/obj/effect/turf_decal/tile/brown/half,
/obj/effect/decal/cleanable/dirt/dust,
/turf/open/floor/iron/smooth_edge,
/area/centcom/tdome/arena)
"d" = (
/obj/machinery/conveyor/auto{
	use_power = 0
	},
/obj/structure/disposalpipe/segment,
/obj/effect/spawner/random/trash/garbage,
/turf/open/floor/plating,
/area/centcom/tdome/arena)
"e" = (
/obj/machinery/conveyor/auto{
	dir = 4;
	use_power = 0
	},
/obj/item/grenade/smokebomb,
/turf/open/floor/plating,
/area/centcom/tdome/arena)
"f" = (
/obj/effect/turf_decal/tile/brown/opposingcorners{
	dir = 1
	},
/obj/effect/decal/cleanable/dirt/dust,
/turf/open/floor/iron/smooth,
/area/centcom/tdome/arena)
"g" = (
/obj/effect/turf_decal/tile/brown/opposingcorners,
/obj/machinery/light/floor,
/obj/effect/decal/cleanable/dirt/dust,
/turf/open/floor/iron/smooth,
/area/centcom/tdome/arena)
"h" = (
/obj/structure/disposalpipe/segment,
/obj/structure/cable/layer1,
/obj/structure/cable,
/obj/structure/cable/layer3,
/turf/open/floor/catwalk_floor/iron_smooth,
/area/centcom/tdome/arena)
"i" = (
/obj/machinery/conveyor/auto{
	dir = 4;
	use_power = 0
	},
/obj/structure/disposalpipe/segment,
/obj/effect/spawner/random/trash/garbage,
/turf/open/floor/plating,
/area/centcom/tdome/arena)
"j" = (
/obj/structure/disposaloutlet,
/obj/structure/disposalpipe/trunk,
/obj/structure/plasticflaps,
/turf/open/floor/iron/dark/textured_large,
/area/centcom/tdome/arena)
"k" = (
/obj/machinery/conveyor/auto{
	dir = 4;
	use_power = 0
	},
/obj/structure/plasticflaps,
/turf/open/floor/plating,
/area/centcom/tdome/arena)
"l" = (
/obj/structure/table/reinforced,
/obj/effect/turf_decal/tile/brown/opposingcorners{
	dir = 1
	},
/obj/item/reagent_containers/cup/glass/bottle/hooch,
/turf/open/floor/iron/smooth,
/area/centcom/tdome/arena)
"m" = (
/obj/structure/table/reinforced,
/obj/effect/turf_decal/tile/brown/opposingcorners,
/obj/item/reagent_containers/cup/glass/bottle/lizardwine,
/obj/effect/decal/cleanable/dirt/dust,
/turf/open/floor/iron/smooth,
/area/centcom/tdome/arena)
"n" = (
/obj/structure/disposalpipe/segment,
/turf/open/floor/catwalk_floor/iron_smooth,
/area/centcom/tdome/arena)
"o" = (
/obj/machinery/conveyor/auto{
	dir = 4;
	use_power = 0
	},
/obj/structure/disposalpipe/segment,
/turf/open/floor/plating,
/area/centcom/tdome/arena)
"p" = (
/obj/effect/turf_decal/tile/brown/half,
/obj/effect/decal/cleanable/dirt/dust,
/obj/structure/table/reinforced,
/turf/open/floor/iron/smooth_edge,
/area/centcom/tdome/arena)
"q" = (
/obj/machinery/conveyor/auto{
	dir = 8;
	use_power = 0
	},
/obj/effect/spawner/random/trash/garbage,
/obj/structure/plasticflaps,
/turf/open/floor/plating,
/area/centcom/tdome/arena)
"r" = (
/obj/effect/turf_decal/tile/brown/half,
/obj/structure/steam_vent,
/turf/open/floor/iron/smooth_edge,
/area/centcom/tdome/arena)
"s" = (
/obj/effect/turf_decal/tile/brown/opposingcorners,
/obj/machinery/light/floor,
/turf/open/floor/iron/smooth,
/area/centcom/tdome/arena)
"t" = (
/obj/effect/turf_decal/tile/brown/half{
	dir = 1
	},
/obj/effect/decal/cleanable/dirt/dust,
/obj/structure/steam_vent,
/turf/open/floor/iron/smooth_edge{
	dir = 1
	},
/area/centcom/tdome/arena)
"u" = (
/obj/effect/turf_decal/tile/brown/opposingcorners,
/obj/effect/decal/cleanable/wrapping,
/turf/open/floor/iron/smooth,
/area/centcom/tdome/arena)
"v" = (
/obj/structure/table/reinforced,
/obj/effect/turf_decal/tile/brown/opposingcorners{
	dir = 1
	},
/obj/item/reagent_containers/cup/glass/bottle/lizardwine,
/turf/open/floor/iron/smooth,
/area/centcom/tdome/arena)
"w" = (
/obj/effect/turf_decal/tile/brown/half{
	dir = 1
	},
/obj/structure/steam_vent,
/turf/open/floor/iron/smooth_edge{
	dir = 1
	},
/area/centcom/tdome/arena)
"x" = (
/obj/machinery/conveyor/auto{
	dir = 8;
	use_power = 0
	},
/obj/item/grenade/smokebomb,
/turf/open/floor/plating,
/area/centcom/tdome/arena)
"y" = (
/obj/machinery/conveyor/auto{
	dir = 8;
	use_power = 0
	},
/obj/structure/plasticflaps,
/turf/open/floor/plating,
/area/centcom/tdome/arena)
"z" = (
/obj/effect/turf_decal/tile/brown/opposingcorners{
	dir = 1
	},
/obj/machinery/light/floor,
/turf/open/floor/iron/smooth,
/area/centcom/tdome/arena)
"A" = (
/obj/effect/turf_decal/tile/brown/half{
	dir = 1
	},
/obj/effect/spawner/random/trash/graffiti,
/turf/open/floor/iron/smooth_edge{
	dir = 1
	},
/area/centcom/tdome/arena)
"B" = (
/obj/effect/turf_decal/tile/brown/opposingcorners,
/obj/effect/spawner/random/trash/graffiti,
/turf/open/floor/iron/smooth,
/area/centcom/tdome/arena)
"D" = (
/obj/effect/turf_decal/tile/brown/opposingcorners,
/turf/open/floor/iron/smooth,
/area/centcom/tdome/arena)
"E" = (
/obj/machinery/disposal/delivery_chute{
	dir = 1
	},
/obj/structure/disposalpipe/trunk{
	dir = 1
	},
/obj/structure/plasticflaps,
/turf/open/floor/iron/dark/textured_large,
/area/centcom/tdome/arena)
"F" = (
/turf/closed/indestructible/fakeglass,
/area/centcom/tdome/arena)
"G" = (
/obj/machinery/conveyor/auto{
	dir = 1;
	use_power = 0
	},
/obj/structure/disposalpipe/segment,
/obj/effect/spawner/random/trash/garbage,
/turf/open/floor/plating,
/area/centcom/tdome/arena)
"H" = (
/turf/closed/indestructible/reinforced,
/area/centcom/tdome/arena)
"I" = (
/obj/machinery/conveyor/auto{
	dir = 4;
	use_power = 0
	},
/obj/effect/spawner/random/trash/garbage,
/obj/structure/plasticflaps,
/turf/open/floor/plating,
/area/centcom/tdome/arena)
"J" = (
/obj/effect/turf_decal/tile/brown/opposingcorners{
	dir = 1
	},
/obj/machinery/light/floor,
/obj/effect/decal/cleanable/wrapping,
/turf/open/floor/iron/smooth,
/area/centcom/tdome/arena)
"K" = (
/obj/structure/disposaloutlet{
	dir = 1
	},
/obj/structure/disposalpipe/trunk{
	dir = 1
	},
/obj/structure/plasticflaps,
/turf/open/floor/iron/dark/textured_large,
/area/centcom/tdome/arena)
"L" = (
/obj/effect/turf_decal/tile/brown/opposingcorners,
/obj/effect/decal/cleanable/dirt/dust,
/turf/open/floor/iron/smooth,
/area/centcom/tdome/arena)
"M" = (
/obj/machinery/conveyor/auto{
	dir = 4;
	use_power = 0
	},
/turf/open/floor/plating,
/area/centcom/tdome/arena)
"N" = (
/obj/machinery/disposal/delivery_chute,
/obj/structure/disposalpipe/trunk,
/obj/structure/plasticflaps,
/turf/open/floor/iron/dark/textured_large,
/area/centcom/tdome/arena)
"Q" = (
/obj/structure/table/reinforced,
/obj/effect/turf_decal/tile/brown/opposingcorners,
/obj/item/reagent_containers/cup/glass/bottle/hooch,
/turf/open/floor/iron/smooth,
/area/centcom/tdome/arena)
"R" = (
/obj/effect/turf_decal/tile/brown/half{
	dir = 1
	},
/turf/open/floor/iron/smooth_edge{
	dir = 1
	},
/area/centcom/tdome/arena)
"S" = (
/obj/machinery/conveyor/auto{
	dir = 8;
	use_power = 0
	},
/turf/open/floor/plating,
/area/centcom/tdome/arena)
"T" = (
/obj/effect/turf_decal/tile/brown/half,
/obj/structure/table/reinforced,
/turf/open/floor/iron/smooth_edge,
/area/centcom/tdome/arena)
"U" = (
/obj/effect/turf_decal/tile/brown/opposingcorners,
/obj/effect/spawner/random/trash/graffiti,
/obj/effect/decal/cleanable/dirt/dust,
/turf/open/floor/iron/smooth,
/area/centcom/tdome/arena)
"V" = (
/obj/machinery/conveyor/auto{
	dir = 8;
	use_power = 0
	},
/obj/structure/disposalpipe/segment,
/obj/effect/spawner/random/trash/garbage,
/turf/open/floor/plating,
/area/centcom/tdome/arena)
"W" = (
/obj/machinery/conveyor/auto{
	dir = 8;
	use_power = 0
	},
/obj/structure/disposalpipe/segment,
/turf/open/floor/plating,
/area/centcom/tdome/arena)
"X" = (
/obj/effect/turf_decal/tile/brown/half{
	dir = 1
	},
/obj/effect/decal/cleanable/dirt/dust,
/obj/structure/table/reinforced,
/turf/open/floor/iron/smooth_edge{
	dir = 1
	},
/area/centcom/tdome/arena)
"Y" = (
/obj/effect/turf_decal/tile/brown/opposingcorners{
	dir = 1
	},
/obj/effect/spawner/random/trash/graffiti,
/turf/open/floor/iron/smooth,
/area/centcom/tdome/arena)
"Z" = (
/obj/machinery/conveyor/auto{
	dir = 1;
	use_power = 0
	},
/obj/structure/disposalpipe/segment,
/turf/open/floor/plating,
/area/centcom/tdome/arena)

(1,1,1) = {"
H
R
U
g
D
L
s
L
b
H
"}
(2,1,1) = {"
j
a
M
a
a
a
d
a
a
E
"}
(3,1,1) = {"
F
F
I
F
F
F
F
y
F
F
"}
(4,1,1) = {"
N
Z
M
n
n
n
n
S
G
K
"}
(5,1,1) = {"
F
t
M
g
Q
m
g
S
r
F
"}
(6,1,1) = {"
j
d
o
h
h
h
h
W
a
E
"}
(7,1,1) = {"
F
X
M
L
u
L
B
S
p
F
"}
(8,1,1) = {"
N
Z
o
n
n
n
n
V
Z
K
"}
(9,1,1) = {"
F
A
e
F
F
F
F
x
c
F
"}
(10,1,1) = {"
j
a
i
n
n
n
n
W
d
E
"}
(11,1,1) = {"
F
X
M
f
Y
f
f
S
T
F
"}
(12,1,1) = {"
N
G
o
h
h
h
h
W
Z
K
"}
(13,1,1) = {"
F
w
M
J
v
l
z
S
r
F
"}
(14,1,1) = {"
j
a
M
n
n
n
n
S
a
E
"}
(15,1,1) = {"
F
F
k
F
F
F
F
q
F
F
"}
(16,1,1) = {"
N
Z
Z
G
Z
Z
Z
S
Z
K
"}
(17,1,1) = {"
H
R
f
z
f
Y
z
f
c
H
"}
