//MAP CONVERTED BY dmm2tgm.py THIS HEADER COMMENT PREVENTS RECONVERSION, DO NOT REMOVE
"ay" = (
/obj/effect/turf_decal/stripes/corner{
	dir = 1
	},
/obj/effect/turf_decal/tile/yellow/half/contrasted,
/turf/open/floor/iron,
/area/centcom/tdome/arena)
"bs" = (
/turf/closed/indestructible/reinforced,
/area/centcom/tdome/arena)
"bx" = (
/obj/effect/turf_decal/trimline/yellow/arrow_cw{
	dir = 4
	},
/turf/open/floor/engine,
/area/centcom/tdome/arena)
"bE" = (
/obj/effect/turf_decal/stripes/corner,
/turf/open/floor/iron/dark/small,
/area/centcom/tdome/arena)
"dq" = (
/obj/effect/turf_decal/stripes/line{
	dir = 8
	},
/obj/effect/decal/cleanable/dirt,
/turf/open/floor/iron,
/area/centcom/tdome/arena)
"fi" = (
/obj/structure/sign/warning/secure_area/directional/east,
/turf/open/floor/engine,
/area/centcom/tdome/arena)
"fq" = (
/obj/machinery/shower{
	dir = 1
	},
/obj/effect/turf_decal/trimline/yellow/end{
	dir = 1
	},
/turf/open/floor/iron/dark,
/area/centcom/tdome/arena)
"ge" = (
/obj/machinery/conveyor/auto{
	use_power = 0
	},
/turf/open/floor/engine,
/area/centcom/tdome/arena)
"hA" = (
/obj/machinery/light/directional/south,
/turf/open/floor/engine,
/area/centcom/tdome/arena)
"hL" = (
/obj/effect/turf_decal/tile/yellow/half/contrasted{
	dir = 8
	},
/turf/open/floor/iron,
/area/centcom/tdome/arena)
"if" = (
/obj/effect/turf_decal/stripes/corner,
/obj/effect/turf_decal/tile/yellow/half/contrasted{
	dir = 1
	},
/obj/effect/decal/cleanable/dirt/dust,
/turf/open/floor/iron,
/area/centcom/tdome/arena)
"ih" = (
/obj/machinery/shower{
	dir = 1
	},
/obj/effect/turf_decal/trimline/yellow/end{
	dir = 1
	},
/obj/effect/decal/cleanable/dirt,
/turf/open/floor/iron/dark,
/area/centcom/tdome/arena)
"ko" = (
/obj/machinery/shower{
	pixel_y = 14
	},
/obj/effect/turf_decal/trimline/yellow/end,
/turf/open/floor/iron/dark,
/area/centcom/tdome/arena)
"nn" = (
/obj/machinery/conveyor/auto{
	dir = 8;
	use_power = 0
	},
/turf/open/floor/engine,
/area/centcom/tdome/arena)
"nt" = (
/obj/structure/rack,
/obj/effect/turf_decal/tile/yellow/half/contrasted,
/obj/effect/turf_decal/bot{
	dir = 1
	},
/obj/item/hand_labeler,
/turf/open/floor/iron,
/area/centcom/tdome/arena)
"of" = (
/obj/effect/turf_decal/stripes/line{
	dir = 4
	},
/turf/open/floor/iron/dark/small,
/area/centcom/tdome/arena)
"os" = (
/obj/effect/turf_decal/delivery,
/turf/open/floor/engine,
/area/centcom/tdome/arena)
"qb" = (
/obj/effect/turf_decal/tile/yellow/anticorner/contrasted{
	dir = 1
	},
/turf/open/floor/iron,
/area/centcom/tdome/arena)
"qg" = (
/obj/machinery/conveyor/auto{
	dir = 6;
	use_power = 0
	},
/turf/open/floor/engine,
/area/centcom/tdome/arena)
"qk" = (
/obj/machinery/conveyor/auto{
	dir = 10;
	use_power = 0
	},
/turf/open/floor/engine,
/area/centcom/tdome/arena)
"qv" = (
/obj/effect/turf_decal/tile/yellow/half/contrasted{
	dir = 8
	},
/obj/effect/decal/cleanable/dirt,
/turf/open/floor/iron,
/area/centcom/tdome/arena)
"rl" = (
/obj/effect/turf_decal/trimline/yellow/arrow_cw{
	dir = 8
	},
/turf/open/floor/engine,
/area/centcom/tdome/arena)
"rW" = (
/turf/open/floor/engine,
/area/centcom/tdome/arena)
"se" = (
/obj/effect/turf_decal/trimline/yellow/arrow_cw{
	dir = 9
	},
/turf/open/floor/engine,
/area/centcom/tdome/arena)
"uz" = (
/obj/structure/table/reinforced,
/obj/machinery/cell_charger,
/obj/effect/turf_decal/tile/yellow/half/contrasted,
/obj/effect/turf_decal/bot{
	dir = 1
	},
/turf/open/floor/iron,
/area/centcom/tdome/arena)
"uT" = (
/obj/machinery/power/supermatter_crystal/shard/hugbox{
	anchored = 0;
	name = "supermatter shard";
	hallucination_power = 0
	},
/obj/machinery/conveyor/auto{
	dir = 8;
	use_power = 0
	},
/turf/open/floor/engine,
/area/centcom/tdome/arena)
"wl" = (
/obj/machinery/conveyor/auto{
	dir = 4;
	use_power = 0
	},
/turf/open/floor/engine,
/area/centcom/tdome/arena)
"xi" = (
/obj/effect/turf_decal/stripes/line{
	dir = 1
	},
/obj/effect/turf_decal/tile/yellow/half/contrasted,
/obj/effect/decal/cleanable/dirt/dust,
/turf/open/floor/iron,
/area/centcom/tdome/arena)
"yr" = (
/obj/effect/turf_decal/stripes/line,
/obj/effect/turf_decal/caution/stand_clear,
/obj/effect/turf_decal/stripes/line{
	dir = 1
	},
/turf/open/floor/engine,
/area/centcom/tdome/arena)
"yJ" = (
/obj/machinery/conveyor/auto{
	dir = 1;
	use_power = 0
	},
/turf/open/floor/engine,
/area/centcom/tdome/arena)
"yW" = (
/obj/effect/turf_decal/tile/yellow/anticorner/contrasted,
/turf/open/floor/iron,
/area/centcom/tdome/arena)
"Bi" = (
/obj/effect/turf_decal/stripes/corner{
	dir = 8
	},
/turf/open/floor/iron/dark/small,
/area/centcom/tdome/arena)
"BT" = (
/obj/effect/turf_decal/stripes/corner{
	dir = 4
	},
/obj/effect/turf_decal/tile/yellow/half/contrasted,
/turf/open/floor/iron,
/area/centcom/tdome/arena)
"Dc" = (
/obj/effect/spawner/structure/window/reinforced/plasma,
/turf/open/floor/engine,
/area/centcom/tdome/arena)
"Dh" = (
/obj/effect/turf_decal/stripes/corner{
	dir = 1
	},
/turf/open/floor/iron/dark/small,
/area/centcom/tdome/arena)
"Ed" = (
/obj/effect/turf_decal/stripes/line{
	dir = 4
	},
/obj/effect/decal/cleanable/dirt,
/turf/open/floor/iron/dark/small,
/area/centcom/tdome/arena)
"FD" = (
/obj/effect/turf_decal/tile/yellow/half/contrasted{
	dir = 4
	},
/turf/open/floor/iron,
/area/centcom/tdome/arena)
"FS" = (
/obj/structure/table/reinforced,
/obj/effect/turf_decal/tile/yellow/half/contrasted,
/obj/effect/turf_decal/bot{
	dir = 1
	},
/turf/open/floor/iron,
/area/centcom/tdome/arena)
"Gc" = (
/obj/effect/turf_decal/trimline/yellow/arrow_cw{
	dir = 10
	},
/turf/open/floor/engine,
/area/centcom/tdome/arena)
"Hl" = (
/turf/open/floor/iron/dark/small,
/area/centcom/tdome/arena)
"IF" = (
/obj/machinery/conveyor/auto{
	dir = 9;
	use_power = 0
	},
/turf/open/floor/engine,
/area/centcom/tdome/arena)
"JE" = (
/obj/structure/sign/warning/secure_area/directional/west,
/turf/open/floor/engine,
/area/centcom/tdome/arena)
"Mj" = (
/obj/effect/turf_decal/stripes/corner{
	dir = 8
	},
/obj/effect/turf_decal/tile/yellow/half/contrasted{
	dir = 1
	},
/turf/open/floor/iron,
/area/centcom/tdome/arena)
"Ms" = (
/obj/effect/turf_decal/stripes/line{
	dir = 4
	},
/turf/open/floor/iron,
/area/centcom/tdome/arena)
"MQ" = (
/obj/effect/turf_decal/trimline/yellow/arrow_cw{
	dir = 6
	},
/turf/open/floor/engine,
/area/centcom/tdome/arena)
"MZ" = (
/obj/structure/table/reinforced,
/obj/machinery/microwave/hell,
/obj/effect/turf_decal/tile/yellow/half/contrasted{
	dir = 1
	},
/obj/effect/turf_decal/bot{
	dir = 1
	},
/turf/open/floor/iron,
/area/centcom/tdome/arena)
"PM" = (
/obj/effect/turf_decal/stripes/line{
	dir = 8
	},
/turf/open/floor/iron,
/area/centcom/tdome/arena)
"PS" = (
/obj/machinery/conveyor/auto{
	dir = 5;
	use_power = 0
	},
/turf/open/floor/engine,
/area/centcom/tdome/arena)
"Rj" = (
/obj/structure/rack,
/obj/effect/turf_decal/tile/yellow/half/contrasted{
	dir = 1
	},
/obj/effect/turf_decal/bot{
	dir = 1
	},
/obj/item/food/chips,
/turf/open/floor/iron,
/area/centcom/tdome/arena)
"Uc" = (
/obj/effect/turf_decal/tile/yellow/anticorner/contrasted{
	dir = 8
	},
/turf/open/floor/iron,
/area/centcom/tdome/arena)
"Uz" = (
/obj/effect/turf_decal/stripes/line{
	dir = 1
	},
/obj/effect/turf_decal/caution/stand_clear,
/obj/effect/turf_decal/stripes/line,
/turf/open/floor/engine,
/area/centcom/tdome/arena)
"UQ" = (
/obj/structure/rack,
/obj/effect/turf_decal/tile/yellow/half/contrasted{
	dir = 1
	},
/obj/effect/turf_decal/bot{
	dir = 1
	},
/obj/item/food/chips,
/obj/effect/decal/cleanable/dirt,
/turf/open/floor/iron,
/area/centcom/tdome/arena)
"Vl" = (
/obj/effect/turf_decal/trimline/yellow/arrow_cw{
	dir = 5
	},
/turf/open/floor/engine,
/area/centcom/tdome/arena)
"VF" = (
/obj/effect/turf_decal/stripes/line{
	dir = 1
	},
/obj/effect/turf_decal/tile/yellow/half/contrasted,
/turf/open/floor/iron,
/area/centcom/tdome/arena)
"Wh" = (
/obj/machinery/light/directional/north,
/turf/open/floor/engine,
/area/centcom/tdome/arena)
"Xo" = (
/obj/machinery/power/emitter/energycannon{
	dir = 1
	},
/turf/open/floor/engine,
/area/centcom/tdome/arena)
"XF" = (
/obj/effect/turf_decal/tile/yellow/anticorner/contrasted{
	dir = 4
	},
/turf/open/floor/iron,
/area/centcom/tdome/arena)
"Ye" = (
/obj/machinery/power/supermatter_crystal/shard/hugbox{
	anchored = 0;
	name = "supermatter shard";
	hallucination_power = 0
	},
/obj/machinery/conveyor/auto{
	dir = 4;
	use_power = 0
	},
/turf/open/floor/engine,
/area/centcom/tdome/arena)
"Yr" = (
/obj/machinery/shower{
	pixel_y = 14
	},
/obj/effect/turf_decal/trimline/yellow/end,
/obj/effect/decal/cleanable/dirt,
/turf/open/floor/iron/dark,
/area/centcom/tdome/arena)
"YF" = (
/obj/effect/turf_decal/stripes/corner{
	dir = 4
	},
/turf/open/floor/iron/dark/small,
/area/centcom/tdome/arena)
"YL" = (
/obj/effect/turf_decal/stripes/line{
	dir = 8
	},
/turf/open/floor/iron/dark/small,
/area/centcom/tdome/arena)
"Zu" = (
/obj/structure/table/reinforced,
/obj/item/storage/box,
/obj/item/radio/off{
	pixel_x = 6
	},
/obj/effect/turf_decal/tile/yellow/half/contrasted{
	dir = 1
	},
/obj/effect/turf_decal/bot{
	dir = 1
	},
/turf/open/floor/iron,
/area/centcom/tdome/arena)
"ZH" = (
/obj/machinery/power/emitter/energycannon,
/turf/open/floor/engine,
/area/centcom/tdome/arena)
"ZV" = (
/obj/effect/turf_decal/stripes/line,
/obj/effect/turf_decal/tile/yellow/half/contrasted{
	dir = 1
	},
/turf/open/floor/iron,
/area/centcom/tdome/arena)

(1,1,1) = {"
rW
rW
rW
rW
rW
rW
rW
rW
rW
rW
"}
(2,1,1) = {"
rW
qb
hL
hL
hL
hL
hL
qv
Uc
rW
"}
(3,1,1) = {"
rW
Rj
Hl
bE
Ed
of
YF
Hl
nt
rW
"}
(4,1,1) = {"
Wh
MZ
Hl
bs
Yr
fq
bs
Hl
FS
hA
"}
(5,1,1) = {"
rW
Zu
Hl
Bi
YL
YL
Dh
Hl
uz
rW
"}
(6,1,1) = {"
rW
if
Ms
Ms
Ms
Ms
Ms
Ms
BT
rW
"}
(7,1,1) = {"
fi
ZV
PS
yJ
yJ
yJ
yJ
IF
VF
fi
"}
(8,1,1) = {"
bs
Dc
wl
se
rl
rl
Gc
nn
Dc
bs
"}
(9,1,1) = {"
ZH
yr
Ye
bs
os
os
bs
uT
Uz
Xo
"}
(10,1,1) = {"
bs
Dc
wl
Vl
bx
bx
MQ
nn
Dc
bs
"}
(11,1,1) = {"
JE
ZV
qg
ge
ge
ge
ge
qk
xi
JE
"}
(12,1,1) = {"
rW
Mj
PM
PM
PM
PM
PM
dq
ay
rW
"}
(13,1,1) = {"
rW
Zu
Hl
bE
of
of
YF
Hl
uz
rW
"}
(14,1,1) = {"
Wh
MZ
Hl
bs
ko
ih
bs
Hl
FS
hA
"}
(15,1,1) = {"
rW
UQ
Hl
Bi
YL
YL
Dh
Hl
nt
rW
"}
(16,1,1) = {"
rW
XF
FD
FD
FD
FD
FD
FD
yW
rW
"}
(17,1,1) = {"
rW
rW
rW
rW
rW
rW
rW
rW
rW
rW
"}
