//MAP CONVERTED BY dmm2tgm.py THIS HEADER COMMENT PREVENTS RECONVERSION, DO NOT REMOVE
"bl" = (
/obj/effect/turf_decal/weather/snow/corner{
	dir = 8
	},
/turf/open/floor/plating/snowed/smoothed/icemoon,
/area/centcom/tdome/arena)
"cc" = (
/obj/structure/fermenting_barrel{
	anchored = 1
	},
/turf/open/floor/wood/large,
/area/centcom/tdome/arena)
"cp" = (
/obj/effect/turf_decal/weather/snow/corner{
	dir = 6
	},
/obj/effect/turf_decal/weather/snow/corner{
	dir = 1
	},
/obj/effect/turf_decal/weather/snow/corner,
/obj/machinery/hydroponics/soil{
	pixel_y = 7;
	color = " #DCDCDC"
	},
/turf/open/misc/dirt,
/area/centcom/tdome/arena)
"go" = (
/obj/structure/dresser,
/turf/open/floor/wood/large,
/area/centcom/tdome/arena)
"hm" = (
/obj/structure/sink/kitchen{
	dir = 8;
	pixel_x = 12
	},
/obj/effect/turf_decal/siding/wood{
	dir = 9
	},
/obj/effect/decal/cleanable/dirt,
/turf/open/floor/iron/diagonal,
/area/centcom/tdome/arena)
"ih" = (
/obj/effect/turf_decal/siding/wood{
	dir = 10
	},
/turf/open/floor/stone{
	initial_gas_mix = "ICEMOON_ATMOS"
	},
/area/centcom/tdome/arena)
"ix" = (
/obj/effect/turf_decal/weather/snow/corner{
	dir = 8
	},
/obj/structure/mineral_door/wood,
/turf/open/floor/wood/large,
/area/centcom/tdome/arena)
"iS" = (
/obj/structure/barricade/wooden/snowed,
/obj/effect/turf_decal/weather/snow/corner,
/turf/open/floor/wood/large,
/area/centcom/tdome/arena)
"lt" = (
/obj/structure/window/reinforced/fulltile/ice,
/obj/structure/barricade/wooden/crude/snow,
/turf/open/space/basic,
/area/centcom/tdome/arena)
"lO" = (
/obj/effect/turf_decal/weather/snow/corner{
	dir = 4
	},
/obj/structure/mineral_door/wood,
/turf/open/floor/wood/large,
/area/centcom/tdome/arena)
"mi" = (
/turf/open/floor/wood/large,
/area/centcom/tdome/arena)
"mv" = (
/obj/structure/flora/tree/dead/style_4,
/turf/open/misc/snow/actually_safe,
/area/centcom/tdome/arena)
"mG" = (
/turf/closed/indestructible/wood,
/area/centcom/tdome/arena)
"oa" = (
/obj/structure/flora/tree/dead/style_5,
/turf/open/misc/snow/actually_safe,
/area/centcom/tdome/arena)
"ol" = (
/obj/structure/fence/door/opened{
	dir = 8
	},
/turf/open/misc/snow/actually_safe,
/area/centcom/tdome/arena)
"oU" = (
/obj/item/stack/sheet/mineral/wood/fifty,
/obj/effect/turf_decal/weather/snow/corner,
/turf/open/floor/wood/large,
/area/centcom/tdome/arena)
"pD" = (
/turf/open/floor/plating/snowed/smoothed/icemoon,
/area/centcom/tdome/arena)
"pQ" = (
/obj/structure/chair/wood{
	dir = 4
	},
/turf/open/floor/wood/large,
/area/centcom/tdome/arena)
"qB" = (
/obj/structure/fence/cut/large,
/turf/open/misc/snow/actually_safe,
/area/centcom/tdome/arena)
"rX" = (
/obj/structure/loom,
/turf/open/floor/wood/large,
/area/centcom/tdome/arena)
"tY" = (
/obj/structure/fence/door/opened{
	dir = 4
	},
/turf/open/misc/snow/actually_safe,
/area/centcom/tdome/arena)
"um" = (
/obj/structure/bookcase/random/religion,
/turf/open/floor/wood/large,
/area/centcom/tdome/arena)
"uD" = (
/obj/effect/turf_decal/siding/wood{
	dir = 6
	},
/turf/open/floor/stone{
	initial_gas_mix = "ICEMOON_ATMOS"
	},
/area/centcom/tdome/arena)
"va" = (
/obj/effect/turf_decal/weather/snow/corner{
	dir = 9
	},
/obj/effect/turf_decal/weather/snow/corner,
/obj/machinery/hydroponics/soil{
	pixel_y = 7;
	color = " #DCDCDC"
	},
/turf/open/misc/dirt,
/area/centcom/tdome/arena)
"vl" = (
/obj/structure/fence,
/turf/open/misc/snow/actually_safe,
/area/centcom/tdome/arena)
"xl" = (
/obj/structure/table/wood,
/obj/item/food/soup/stew{
	name = "porridge";
	pixel_y = 3
	},
/obj/item/candle{
	start_lit = 1;
	pixel_y = 13;
	pixel_x = -4
	},
/turf/open/floor/wood/large,
/area/centcom/tdome/arena)
"yB" = (
/obj/effect/turf_decal/siding/wood{
	dir = 8
	},
/turf/open/floor/stone{
	initial_gas_mix = "ICEMOON_ATMOS"
	},
/area/centcom/tdome/arena)
"zi" = (
/obj/structure/bookcase/random/fiction,
/turf/open/floor/wood/large,
/area/centcom/tdome/arena)
"zl" = (
/obj/item/wallframe/painting/large,
/turf/closed/indestructible/wood,
/area/centcom/tdome/arena)
"Ah" = (
/obj/structure/closet/secure_closet/freezer/kitchen,
/obj/effect/turf_decal/siding/wood{
	dir = 8
	},
/obj/effect/decal/cleanable/dirt,
/turf/open/floor/iron/diagonal,
/area/centcom/tdome/arena)
"By" = (
/obj/effect/turf_decal/weather/snow/corner{
	dir = 10
	},
/turf/open/floor/plating/snowed/smoothed/icemoon,
/area/centcom/tdome/arena)
"ET" = (
/obj/structure/flora/tree/stump{
	dir = 1
	},
/turf/open/misc/snow/actually_safe,
/area/centcom/tdome/arena)
"EZ" = (
/turf/open/misc/snow/actually_safe,
/area/centcom/tdome/arena)
"Fh" = (
/obj/effect/turf_decal/siding/wood,
/obj/effect/decal/cleanable/dirt,
/turf/open/floor/stone{
	initial_gas_mix = "ICEMOON_ATMOS"
	},
/area/centcom/tdome/arena)
"FF" = (
/obj/structure/chair/wood{
	dir = 8
	},
/turf/open/floor/wood/large,
/area/centcom/tdome/arena)
"FM" = (
/obj/structure/railing{
	color = "#8a7453";
	dir = 8
	},
/turf/open/misc/snow/actually_safe,
/area/centcom/tdome/arena)
"Gi" = (
/obj/item/flashlight/lantern,
/obj/structure/table/wood,
/turf/open/floor/wood/large,
/area/centcom/tdome/arena)
"GL" = (
/obj/structure/fence/cut/large{
	dir = 1
	},
/turf/open/misc/snow/actually_safe,
/area/centcom/tdome/arena)
"HK" = (
/obj/structure/fence/post,
/turf/open/misc/snow/actually_safe,
/area/centcom/tdome/arena)
"Ju" = (
/obj/structure/railing{
	color = "#8a7453";
	dir = 4
	},
/turf/open/misc/snow/actually_safe,
/area/centcom/tdome/arena)
"Pb" = (
/obj/effect/decal/cleanable/dirt,
/turf/open/floor/wood/large,
/area/centcom/tdome/arena)
"Re" = (
/obj/effect/turf_decal/weather/snow/corner{
	dir = 1
	},
/obj/effect/turf_decal/weather/snow/corner,
/obj/machinery/hydroponics/soil{
	pixel_y = 7;
	color = " #DCDCDC"
	},
/turf/open/misc/dirt,
/area/centcom/tdome/arena)
"RD" = (
/obj/structure/fluff/fokoff_sign,
/turf/open/misc/snow/actually_safe,
/area/centcom/tdome/arena)
"Ty" = (
/obj/item/wallframe/picture{
	pixel_x = -30
	},
/turf/open/floor/wood/large,
/area/centcom/tdome/arena)
"Vj" = (
/obj/item/storage/book/bible{
	pixel_y = 5
	},
/obj/structure/table/wood,
/turf/open/floor/wood/large,
/area/centcom/tdome/arena)
"WQ" = (
/obj/effect/decal/cleanable/dirt,
/obj/effect/decal/cleanable/dirt,
/turf/open/floor/wood/large,
/area/centcom/tdome/arena)
"Xt" = (
/obj/structure/fireplace,
/turf/open/floor/stone{
	initial_gas_mix = "ICEMOON_ATMOS"
	},
/area/centcom/tdome/arena)
"ZN" = (
/obj/effect/turf_decal/siding/wood{
	dir = 4
	},
/turf/open/floor/stone{
	initial_gas_mix = "ICEMOON_ATMOS"
	},
/area/centcom/tdome/arena)

(1,1,1) = {"
EZ
pD
EZ
EZ
EZ
EZ
EZ
EZ
EZ
EZ
"}
(2,1,1) = {"
pD
By
pD
EZ
EZ
mv
EZ
EZ
ET
EZ
"}
(3,1,1) = {"
mG
ix
mG
mG
mG
mG
vl
ol
HK
qB
"}
(4,1,1) = {"
zi
mi
Ty
rX
cc
mG
EZ
pD
EZ
EZ
"}
(5,1,1) = {"
um
mi
Pb
mi
mi
iS
EZ
EZ
EZ
EZ
"}
(6,1,1) = {"
Vj
mi
WQ
mi
Pb
oU
pD
EZ
pD
EZ
"}
(7,1,1) = {"
Pb
Pb
mi
mi
mi
mG
Ju
EZ
EZ
EZ
"}
(8,1,1) = {"
yB
ih
mi
mi
pQ
lt
va
EZ
EZ
EZ
"}
(9,1,1) = {"
Xt
Fh
mi
Pb
xl
lt
Re
EZ
EZ
EZ
"}
(10,1,1) = {"
ZN
uD
mi
mi
FF
lt
cp
EZ
pD
pD
"}
(11,1,1) = {"
mi
Pb
mi
mi
mi
mG
FM
EZ
EZ
EZ
"}
(12,1,1) = {"
Gi
mi
mi
mi
Pb
oU
EZ
EZ
EZ
EZ
"}
(13,1,1) = {"
go
mi
Pb
Pb
mi
iS
EZ
EZ
EZ
pD
"}
(14,1,1) = {"
zl
mi
mi
hm
Ah
mG
pD
EZ
EZ
EZ
"}
(15,1,1) = {"
mG
lO
mG
mG
mG
mG
vl
tY
HK
GL
"}
(16,1,1) = {"
pD
bl
pD
EZ
EZ
oa
EZ
EZ
RD
EZ
"}
(17,1,1) = {"
EZ
pD
EZ
EZ
EZ
EZ
EZ
EZ
EZ
EZ
"}
